w: 10 h: 7
1 1 1 1 1 1 1 1 1 1
1 0 0 0 1 8 1 0 0 1
1 0 0 0 4 0 4 0 5 1
1 0 0 0 1 0 1 0 0 1
2 2 2 0 2 0 2 2 2 2
0 0 2 0 0 0 2 0 0 0
0 0 2 2 2 2 2 0 0 0
