w: 10 h: 10
1 1 1 1 1 1 1 1 1 1
1 0 0 0 0 0 0 0 0 1
1 0 8 0 0 0 0 0 0 1
1 0 0 3 4 3 3 3 0 1
1 0 0 3 0 0 0 3 0 1
1 0 0 3 0 5 0 3 0 1
1 0 0 3 0 0 0 3 0 1
1 0 0 3 3 3 3 3 0 1
1 0 0 0 0 0 0 0 8 1
1 1 1 1 1 1 1 1 1 1
